111111111111111111111111
100000000000000000000001
100000000000000000000001
100000000000000000000001
100000222220000303030001
100000200020000000000001
100000200020000303030001
100000200020000000000001
100000220220000303030001
100000000000000000000001
100000000000000000000001
100000000000000000000001
100000000000000000000001
100000000000000000000001
100000000000000000000001
100000000000000000000001
144444444400000000000001
140400000400000000000001
140000050400000000000001
140400000400000000000001
140444444400000000000001
140000000000000000000001
144444444400000000000001
111111111111111111111111